10 10
# # # # # # # # # #
. . # . . . . . . #
# . # . # . # # . #
# . # . # # # # . #
# . # . . . . # . #
# . # . # # # # . #
# . # . . . . # . #
# . # # # # . # . #
# . . . . . . # . .
# # # # # # # # # #
